R        900 900     
NO ./textures/Meme1.xpm
SO ./textures/Meme2.xpm
WE ./textures/Meme3.xpm
EA ./textures/Meme4.xpm
S  ./textures/Meme5.xpm
F      220,  150,10
C 225,35,30
11111111111
12222222221
12222222221
12222222221
12222222221
12222222221
12222E22221
11111111111